La migliore canzone italiana di sempre | La canzone italiana più sopravvalutata
Il miglior sport da guardare in TV | Lo sport più noioso da guardare
Il piatto che rappresenta meglio l’Italia | Il piatto italiano più controverso
La città più bella d’Italia | La città italiana più deludente
Il film italiano più divertente | Il film italiano più incomprensibile
L’animale domestico perfetto | L’animale domestico più impegnativo
La stagione più bella | La stagione più sopravvalutata
Il dolce più buono | Il dolce più stucchevole
Il regalo perfetto | Il regalo più inutile
Il miglior modo di passare un sabato sera | Il modo più noioso di passare un sabato sera
La festa più divertente | La festa più sopravvalutata
La serie TV più coinvolgente | La serie TV più esagerata
Il colore più bello | Il colore più fastidioso
La materia più interessante a scuola | La materia più inutile a scuola
La miglior pizza | La pizza più strana
La vacanza ideale | La vacanza più stressante
La persona famosa più simpatica | La persona famosa più sopravvalutata
Il personaggio dei cartoni animati migliore | Il personaggio dei cartoni animati più irritante
La cosa più rilassante | La cosa più noiosa
Il miglior hobby | Il passatempo più inutile
Il miglior frutto | Il frutto più sopravvalutato
Il vestito perfetto per una festa | Il vestito meno adatto per una festa
La città più romantica | La città meno romantica
La canzone più romantica | La canzone d’amore più sopravvalutata
La cosa più importante in un’amicizia | La cosa più sopravvalutata in un’amicizia
Il videogioco più divertente | Il videogioco più frustrante
La cosa più bella dell’estate | La cosa più fastidiosa dell’estate
Il miglior superpotere | Il superpotere più inutile
Il miglior attore italiano | L’attore italiano più sopravvalutato
Il modo migliore per rilassarsi | Il modo meno efficace per rilassarsi
La torta più buona | La torta più sopravvalutata
Il miglior tipo di vacanza | Il tipo di vacanza più faticoso
Il profumo più buono | Il profumo più fastidioso
Il lavoro dei sogni | Il lavoro più stressante
Il modo migliore per iniziare la giornata | Il modo peggiore per iniziare la giornata
La canzone più orecchiabile | La canzone più irritante
Il miglior libro che hai letto | Il libro più noioso che hai letto
La cosa che rende felici | La cosa che non porta alcuna felicità
La foto perfetta da mettere sui social | La foto meno adatta da mettere sui social
Il miglior modo per passare una domenica | Il modo più noioso per passare una domenica
Il programma TV migliore | Il programma TV più trash
Il gadget tecnologico più utile | Il gadget tecnologico più inutile
La cosa più sottovalutata | La cosa più sopravvalutata
La bevanda estiva perfetta | La bevanda estiva più deludente
La cosa più divertente da fare con gli amici | La cosa più noiosa da fare con gli amici
Il modo perfetto per dichiararsi | Il modo più imbarazzante per dichiararsi
Il miglior tipo di gelato | Il gusto di gelato più strano
Il cibo da fast food più buono | Il cibo da fast food più deludente
La pubblicità più bella | La pubblicità più irritante
Il film più emozionante di sempre | Il film più sopravvalutato di sempre
Il posto migliore per una luna di miele | Il posto peggiore per una luna di miele
Il personaggio storico più interessante | Il personaggio storico più controverso
Il miglior cibo da mangiare al cinema | Il cibo più fastidioso da mangiare al cinema
La lingua più affascinante | La lingua più difficile da imparare
Il miglior animale del regno animale | L'animale più sottovalutato
Il posto perfetto per vivere | Il posto meno adatto per vivere
La vacanza più rilassante | La vacanza più caotica
Il regalo di compleanno perfetto | Il regalo di compleanno più inutile
Il momento più bello della giornata | Il momento più noioso della giornata
Il programma TV più nostalgico | Il programma TV più dimenticabile
Il personaggio Disney più amato | Il personaggio Disney più fastidioso
Il modo migliore per festeggiare un compleanno | Il modo peggiore per festeggiare un compleanno
La colazione perfetta | La colazione più deludente
Il miglior mezzo di trasporto | Il mezzo di trasporto più scomodo
Il miglior sport da praticare | Lo sport più faticoso
Il miglior film d’animazione | Il film d’animazione più sopravvalutato
Il lavoro più gratificante | Il lavoro più stressante
Il luogo ideale per una vacanza invernale | Il luogo meno adatto per una vacanza invernale
Il gadget da cucina più utile | Il gadget da cucina più inutile
Il giorno più bello dell’anno | Il giorno più noioso dell’anno
Il cibo da festa perfetto | Il cibo da festa più fuori luogo
La canzone più triste | La canzone meno emozionante
Il miglior profumo naturale | L’odore più sgradevole
La bevanda invernale perfetta | La bevanda invernale più deludente
Il miglior cartone animato della tua infanzia | Il cartone più dimenticabile
Il miglior modo per passare il tempo in treno | Il modo peggiore per passare il tempo in treno
La cosa più utile da portare in campeggio | La cosa più inutile da portare in campeggio
Il dessert perfetto | Il dessert più deludente
La giornata perfetta | La giornata peggiore
Il miglior strumento musicale | Lo strumento musicale più difficile
Il miglior artista musicale italiano | L’artista musicale italiano più sopravvalutato
Il momento più imbarazzante | Il momento più divertente
Il piatto tipico più buono | Il piatto tipico meno apprezzato
La miglior invenzione della storia | L’invenzione più inutile della storia
Il modo migliore per svegliarsi | Il modo peggiore per svegliarsi
Il miglior supereroe | Il supereroe più debole
La vacanza da sogno | La vacanza da incubo
Il miglior attore internazionale | L’attore internazionale più sopravvalutato
La serie TV più sottovalutata | La serie TV più sopravvalutata
Il videogioco più iconico | Il videogioco più noioso
Il miglior snack salato | Lo snack più deludente
Il capo d’abbigliamento più comodo | Il capo d’abbigliamento più scomodo
Il periodo storico più affascinante | Il periodo storico più caotico
La miglior app per smartphone | L’app più inutile
La cosa più importante in una relazione | La cosa meno importante in una relazione
La canzone che mette più allegria | La canzone che rovina l’umore
Il modo migliore per affrontare un lunedì | Il modo peggiore per iniziare la settimana
Il modo perfetto per passare il Capodanno | Il modo peggiore per passare il Capodanno
Il film più spaventoso | Il film horror meno spaventoso
Il personaggio più carismatico | Il personaggio più antipatico
Il sogno nel cassetto | Il sogno più irrealizzabile
La pubblicità più simpatica | La pubblicità più fastidiosa
La cosa più bella dell’autunno | La cosa più noiosa dell’autunno
La serie animata più iconica | La serie animata più dimenticabile
Il gadget tecnologico più cool | Il gadget più inutile
Il miglior modo di viaggiare | Il modo più scomodo di viaggiare
Il lavoro ideale | Il lavoro meno desiderato
Il miglior tipo di pane | Il tipo di pane più sopravvalutato
Il gioco da tavolo più divertente | Il gioco da tavolo più noioso
Il miglior regalo ricevuto | Il regalo più deludente ricevuto
La cosa più utile da avere sempre con sé | La cosa meno utile da avere con sé
Il miglior evento dell’anno | L’evento più sopravvalutato dell’anno
Il tipo di scarpa più comoda | Il tipo di scarpa più scomoda
Il posto migliore per leggere un libro | Il posto peggiore per leggere un libro
La cosa più interessante da collezionare | La collezione più inutile
Il cibo che mette più nostalgia | Il cibo meno emozionante
Il miglior passatempo durante la pioggia | Il passatempo più noioso durante la pioggia
Il miglior attore comico | L’attore comico meno divertente
Il miglior tipo di vacanza con amici | Il tipo di vacanza più stressante con amici
Il miglior momento della settimana | Il momento più pesante della settimana
Il miglior sport di squadra | Lo sport di squadra più difficile
Il miglior strumento da cucina | Lo strumento da cucina meno utile
La cosa più utile da imparare a scuola | La cosa meno utile da imparare a scuola
Il miglior modo per rilassarsi dopo il lavoro | Il modo meno rilassante dopo il lavoro
Il miglior cibo per un picnic | Il cibo meno adatto a un picnic
Il miglior luogo per un primo appuntamento | Il luogo peggiore per un primo appuntamento
Il personaggio più simpatico dei fumetti | Il personaggio più fastidioso dei fumetti
La pubblicità più creativa | La pubblicità più ripetitiva
Il miglior mezzo per esplorare una città | Il mezzo più scomodo per esplorare una città
Il dessert più bello da vedere | Il dessert meno invitante
Il modo migliore per passare una serata d’inverno | Il modo peggiore per passare una serata d’inverno
Il miglior modo per fare amicizia | Il modo più imbarazzante per fare amicizia
Il miglior film comico | Il film comico meno divertente
La canzone da karaoke perfetta | La canzone da karaoke più difficile
La giornata perfetta in spiaggia | La giornata peggiore in spiaggia
Il miglior tipo di colazione | Il tipo di colazione meno saziante
Il miglior comfort food | Il comfort food più sopravvalutato
La cosa più importante da portare in montagna | La cosa più inutile in montagna
La stagione più sottovalutata | La stagione più sopravvalutata
Il miglior animale fantastico | L’animale fantastico meno utile
Il miglior tipo di film | Il tipo di film più noioso
La cosa più divertente da fare in famiglia | La cosa più noiosa da fare in famiglia
età media in cui si va a vivere da soli | età in cui una persona cambia casa per la prima volta
numero di viaggi all'anno che una persona vorrebbe fare | numero di viaggi all'anno che una persona riesce davvero a fare
numero di scarpe che una persona media possiede | numero di scarpe che usi veramente
numero ideale di ore di sonno a notte | numero reale di ore che dormi ogni notte
quante tazze di caffè si bevono in media al giorno | quante se ne bevono nei periodi stressanti
numero di serie TV iniziate e mai finite | numero di serie TV viste più di una volta
numero ideale di vacanze all'anno | numero minimo per sentirsi rigenerati
età in cui si prende la patente | età in cui si guida da soli per la prima volta
numero medio di amici stretti | numero di amici con cui ti senti ogni settimana
quante volte si controlla il telefono al giorno | quante volte si dovrebbe controllare al giorno
numero di ore passate sui social ogni settimana | numero di ore che sembrano passate sui social
quanti esami si passano al primo colpo | quanti esami si ripetono almeno una volta
quanti film si guardano in un mese | quanti film si iniziano ma non si finiscono
quanti messaggi si mandano al giorno | quanti se ne leggono e non si risponde
età in cui si ha il primo lavoro retribuito | età in cui si capisce quanto vale il proprio tempo
numero medio di password usate | numero di password ricordate a memoria
numero di paesi che si vorrebbe visitare | numero di paesi visitati finora
quanti libri si leggono in un anno | quanti libri si iniziano e non si finiscono
quanti regali si fanno a Natale | quanti regali si ricevono a Natale
numero di sport provati nella vita | numero di sport praticati con costanza
quante app si hanno installate | quante app si usano ogni giorno
quanti account social si posseggono | quanti se ne usano regolarmente
Un cibo che odiavi da piccolo | Un cibo che hai sempre amato
Una serie TV da binge-watchare | Una serie TV che richiede riflessione
Un personaggio famoso che stimi | Uno che ti incuriosisce ma non ti convince
Una lingua che vorresti imparare | Una lingua che ti incuriosisce ma non studieresti mai
Una cosa che porteresti su un'isola deserta | Una cosa che non servirebbe su un'isola deserta
Una canzone da karaoke | Una canzone impossibile da cantare ma che ami
Un’attività sportiva divertente | Un’attività sportiva faticosa ma soddisfacente
Un piatto tipico della tua regione | Un piatto tipico che hai scoperto altrove
Un momento imbarazzante in pubblico | Un momento che ti ha reso fiero in pubblico
Un oggetto da tenere sulla scrivania | Un oggetto che sparisce sempre quando serve
Un animale marino affascinante | Un animale terrestre altrettanto interessante
Un’attività da fare quando piove | Una da fare sotto il sole cocente
Una festività che ami | Una festività che ti mette nostalgia
Un cibo da strada delizioso | Un piatto da ristorante stellato che hai provato
Una cosa che odi dimenticare a casa | Una cosa inutile che porti sempre con te
Un animale che trovi elegante | Un animale che trovi simpatico
Un simbolo di libertà | Un simbolo di responsabilità
Un locale perfetto per una serata tranquilla | Un locale per serate movimentate
Un errore che ti ha insegnato qualcosa | Un successo che ti ha sorpreso
Un animale che vorresti come compagno d’avventura | Un animale che sarebbe difficile da gestire come compagno
Un'app indispensabile | Un'app che usi troppo spesso
Un gioco da fare in compagnia | Un gioco che ti prende anche da solo
Un'app che tutti usano | Un'app che solo tu conosci
Un oggetto che conservi da anni | Uno che cambi spesso
Una canzone d’amore | Una canzone di rottura che ami
Un'attività da fare al mattino | Un'attività da fare a notte fonda
Un'abitudine quotidiana | Un'abitudine che vuoi perdere
Una frase che ti ripeti spesso | Una frase che odi sentirti dire
Un colore che mette allegria | Un colore che trasmette calma
Un segreto buffo che puoi dire | Un dettaglio di te che nessuno sa
Una tua stranezza | Una tua abitudine comune
Un posto dove perderti | Un posto dove ritrovarti
Un film che tutti dovrebbero vedere almeno una volta | Un film che molti sopravvalutano
Un capo d’abbigliamento che non metti mai | Un capo che indossi troppo spesso
Un luogo dove hai riso tanto | Un luogo dove hai pianto
Un’attività creativa | Un’attività ripetitiva ma rassicurante
Un hobby rilassante | Un hobby stimolante ma stancante
Una cosa che ti rilassa a fine giornata | Una cosa che fai appena sveglio
Un evento che aspetti ogni anno | Uno che eviti
Un gusto di gelato preferito | Un gusto che provi solo ogni tanto
Un oggetto vintage che vorresti avere | Un oggetto futuristico che ti incuriosisce
Un sogno ricorrente | Un sogno che hai fatto solo una volta ma ricordi benissimo
Un animale simbolico | Un animale che ti rappresenta personalmente
Un animale veloce | Un animale incredibilmente paziente
Una cosa che ti dà nostalgia | Una cosa che ti fa ridere ogni volta
Una vacanza che sogni da tempo | Una vacanza che hai fatto e non rifaresti
Una parola che suona bene | Una parola difficile da pronunciare
Una città da visitare in autunno | Una città che sorprende in inverno
Un gesto romantico | Un gesto buffo che ha funzionato
Un regalo perfetto per un amico | Un regalo strano ma memorabile
Un’attività da fare con amici | Un’attività da fare da soli
Un gadget tecnologico che usi spesso | Un gadget che hai ma non usi mai
Un’attività tipica del weekend | Un’attività che fai nei momenti liberi in settimana
Un capo d’abbigliamento comodo | Un capo d’abbigliamento elegante ma scomodo
Un lavoro che faresti per passione | Un lavoro che non faresti mai
Una cosa da portare in campeggio | Una cosa inutile da portare in campeggio
Un piatto perfetto per un primo appuntamento | Un piatto da evitare al primo appuntamento
Un oggetto inutile ma affascinante | Un oggetto utile ma brutto
Una competenza che vuoi imparare | Una che ti piacerebbe insegnare
Un luogo ideale per leggere un libro | Un luogo insolito in cui leggere un libro
Un artista sottovalutato | Un artista conosciutissimo ma che non ti convince
Un artista italiano che ti piace | Un artista straniero che segui da tempo
Un’attività che ti rilassa | Un’attività che ti carica di energia
Un’attività che ti faceva paura | Una che adesso ti rilassa
Un film da vedere con la famiglia | Un film da vedere da soli
Una persona che ammiri | Una persona che ti ha insegnato molto, anche involontariamente
Un colore per una stanza | Un colore per un accessorio
Una serie animata indimenticabile | Una serie animata che non tutti conoscono
Un oggetto che porti sempre con te | Un oggetto che non usi mai ma non riesci a buttare
Un profumo che ami | Un profumo che ti ricorda qualcosa
Un ricordo recente | Un ricordo che sembra lontanissimo
Un personaggio storico affascinante | Un personaggio storico controverso
Un dolce per una festa | Un dolce che crea dibattito
Una canzone che mette subito di buon umore | Una canzone che ti fa pensare
Una pubblicità che ti è rimasta impressa | Una pubblicità che hai odiato
Un libro che rileggi spesso | Un libro che ti ha sorpreso
Un film che tutti amano | Uno che pochi conoscono ma che ti ha colpito
Un colore che indossi spesso | Uno che eviti sempre
Una citazione che ti ispira | Una frase che ti diverte
Un’esperienza che consiglieresti | Una che non rifaresti ma è servita
Una meta per un viaggio on the road | Una meta per un viaggio di relax totale
Un cibo da mangiare d’estate | Un cibo che ami anche fuori stagione
Una bevanda da spiaggia | Una bevanda da serata invernale
Un ricordo d’infanzia felice | Un ricordo d’infanzia buffo
Un’esperienza che vuoi rifare | Un’esperienza che è stata unica ma non rifaresti
Un animale domestico comune | Un animale domestico non convenzionale
Un oggetto tecnologico utile | Uno superfluo ma divertente
Una cosa che odi fare | Una cosa che ami anche se è faticosa
Un regalo che hai ricevuto | Un regalo che hai fatto con amore
Un film d’azione memorabile | Un film drammatico che ti ha colpito
Un film che ti ha fatto piangere | Un film che ti ha fatto ridere a crepapelle